11111111111111111
1C000C000001000C1
1C0C0011000000011
1C0000C00000C0001
100C00010C0100C01
1010C011P00010001
10C01CC01C0000001
1000000C0010000C1
10000011C000E0001
11000000C00001001
10000000001011C11
1100C10011CC1C001
1000000000001C001
101000C0C00000001
111C1001010C00C11
1000000CC000000C1
110000C000CCCC001
100C000C000C010C1
111C001C010010001
1000C000C0100C001
101000C00C1000001
10C0C0000C1000001
1C1C00C0101100001
1010C000C00011011
11111111111111111
