11111111111111
10101E1EE11111
1P00E0E1E01101
110C00E0E00111
10000000EE00E1
11111111111111
